================================
|                          f   |
|                      1  +++  |
|           1  +++    +++      |
|          +++                 |
|     +++                      |
|   p             1            |
++++++++++++++++++++++++++++++++
********************************
********************************