================================
|                              |
|                              |
|                     1        |
|   p                +++       |
|                              |
|                           f  |
++++++++++++++++++++++++++++++++
********************************
********************************
